start=12,01

01,01 01,02 01,03 01,04 01,05 01,06 01,07 01,08 01,09 01,10 01,11 01,12 01,13 01,14 01,15 01,16 01,17 01,18 01,19 01,20 01,21 01,22 01,23 01,24 01,25 01,26 01,27 01,28 01,29 01,30
02,01 02,02                                                                                           02,18                   02,22       02,24                               02,30
03,01       03,03 03,04 03,05                                                 03,14                   03,18       03,20       03,22       03,24       03,26 03,27 03,28 03,29 03,30
04,01                         04,06 04,07 04,08                               04,14                   04,18       04,20       04,22       04,24                               04,30
05,01                                           05,09 05,10 05,11             05,14                   05,18       05,20       05,22       05,24       05,26 05,27 05,28 05,29 05,30
06,01                                                             06,12 06,13                         06,18       06,20       06,22       06,24                                    
07,01       07,03 07,04 07,05 07,06 07,07 07,08 07,09 07,10 07,11                                     07,18       07,20       07,22       07,24       07,26 07,27 07,28 07,29 07,30
08,01                                                                               08,15 08,16                   08,20       08,22                                           08,30
09,01       09,03 09,04 09,05 09,06 09,07 09,08 09,09 09,10 09,11                                     09,18       09,20       09,22       09,24       09,26 09,27 09,28 09,29 09,30
10,01                                                             10,12 10,13                         10,18       10,20       10,22       10,24                               10,30
11,01                                           11,09 11,10 11,11             11,14                   11,18       11,20       11,22       11,24       11,26 11,27 11,28 11,29 11,30
                              12,06 12,07 12,08                               12,14                   12,18       12,20       12,22       12,24                               12,30
13,01       13,03 13,04 13,05                                                 13,14                   13,18       13,20       13,22       13,24       13,26 13,27 13,28 13,29 13,30
14,01 14,02                                                                                           14,18       14,20                   14,24                               14,30
15,01 15,02 15,03 15,04 15,05 15,06 15,07 15,08 15,09 15,10 15,11 15,12 15,13 15,14 15,15 15,16 15,17 15,18 15,19 15,20 15,21 15,22 15,23 15,24 15,25 15,26 15,27 15,28 15,29 15,30
